 _
 
 
 ____________________________________________________________________________________________
|                                                                                            |
|               [                                                                            |
|              / \ ________________________________________________                          |
|     _______/|   |                             |        |         |                         |
|    |         \_/                              |________|         |                         |
|    |                                                             |                         | 
|    |                       Destroyer                             |                         |
|    |          _                                                  |                         |
|    |_______  / \                                                 |                         |
|            \|   |________________________________________________|                         |
|              \ /                          |    submarine      /                            |
|               [                            \_________________/                             |
|                                                                                            |
|                                                                                            |
|____________________________________________________________________________________________|

