

 ____________________________________________________________________________________________
|                                                                                            |
|                                                                                            |
|                                                                                            |
|                                                                           _____            |
|                                                                          /     |           |
|                                                                         /      |           |
|                    ____________                                       -] bunker|           |
|                   |             \                                       \ NAZI |           |
|                   |              \                                       \_____|           |
|                   |               \                                       _____            |
|                   |                |                                     /     |           |
|                   |   Tranchée    /                                     /      |           |
|                   |              /                                    -] bunker|           |
|                   |             /                                       \ NAZI |           |
|                   |            |                                         \_____|           |
|                   |            |                                          _____            |
|                   |            |                                         /     |	     |
|                   |            |                                        /      |           |
|                   |            |                                      -] bunker|           |
|                   |            |                                        \ NAZI |           |
|                   |            |                                         \_____|           |
|___________________|____________|___________________________________________________________|     

