


 ____________________________________________________________________________________________
|                               | |                                                          |
|                               | |                                                          |
|                               | |                                                          |
|______________________________/   \_________________________________________________________|
|                                                                                            |
|                                        ____________________________________________________|
|           ____   ____   ____          |                                                    |
|          |    | |    | |    |         |                           ___________              |
|          |    | |    | |    |         |                          |           |             |
|          |    | |    | |    |         |                          |           |             |
|          |____| |____| |____|         |                          |           |             |
|                                       |                          |           |             |
|           ____   ____   ____          |       Shower             |           |   Furnace   |
|          |    | |    | |    |         |                          |           |             |
|          |    | |    | |    |         |                          |           |             |
|          |    | |    | |    |         |                          |           |             | 
|          |____| |____| |____|         |                          |           |             |
|                                       |                          |           |             |
|           ____   ____   ____          |                          |           |             |
|          |    | |    | |    |         |                          |           |_____________|
|          |    | |    | |    |         |                          |                         |
|          |    | |    | |    |         |__________      __________|                         |
|          |____| |____| |____|                                                              |
|                                                                                            |
|           ____   ____   ____          |                                                    |
|          |    | |    | |    |         |                                                    |
|          |    | |    | |    |         |                                                    |
|          |    | |    | |    |         |                                                    | 
|          |____| |____| |____|         |                        Archive                     |                                                                                            |                                       |                                                    |
|                                       |                                                    |
|                                       |                                                    |
|_______________________________________|____________________________________________________| 